111111111111111111111111111111
11                          11
11                          11111
11  P                          11
11                          11111
11                          11
11111111111E111111111111111111
