1111111111111111111111111111111111111111111111111111
11           11                                   11
11           11                  11        11     11           111111111111111111111111111111
11           11      11          11        11     11           11                          11
11           11      11          11          1111111           11                          11
11           11      11          11          1111111           11                          11
11           11      11                           11           11                          11
11  111      11      11     111111111111          11           11                          11
11    1              11     111111111111          11           11     1111                 11
11    1              11                           11           11     1111                 11
11    1              11                           111111111111111             111111111111111
11    1              11                                             1111111111111111111111111
11    1              11                           111111111111111   1111111111             11
11    1              11                           11           11                1  111111111
11    1              11                           11           11                1         11
11    1              11                           11           11                11111111  11
11    1              11                           11           11                1         11
11    1              11                           11           11                1E11      11
11    1              11                           11           111111111111111111111111111111
11 P  1              11                           11
11    1              11                           11
1111111111111111111111111111111111111111111111111111
