1111111111111111111111111111111111111111111111111111
11           11                                   11
11           11                  11        11     11
11           11      11          11        11     11
11           11      11          11          1111111
11           11      11          11          1111111
11           11      11                           11
11  111      11      11     111111111111          11
11    1              11     111111111111          11
11    1              11                          P11
1111E11111111111111111111111111111111111111111111111
